111111111111100001111111111111
100000000100000000010000011001
100000000100000000010000011001
100111100100111111110010000001
100100000100000010010010000001
100100000100000010010011111001
111100100111110010000001000001
100000100000000010000001000001
100000100000000010011111001001
100100111111111110011000001001
100100001001111000011000001001
100100001001000000011001001111
100111001001000001111001000001
100111001001001111111001000000
100111111001001001111001111000
100000000000001000000001001000
100000000000001000000001001000
111100111111111110011111001001
100000100000010000000000001001
100000100000010000000000001001
100100100111110011111001001001
100100100110000000001001001001
100100000010000000001001111001
100100000010011110001000000001
100000110010000010001000000001
100000110010000010011111111001
111111110011111110011111111001
100000000000000010000000000001
100000000000000010000000000001
111111111111111111111111111111

111111111111100001111111111111
100100000000000000100000000001
100100000000000000100000000001
100100111111111100100111111111
100100000000000100100000000001
100100000000000100100000000001
100000100100111100111111111001
100000100100000000001000000001
111111100100000000001000000001
100000000100001001111001111111
100000000111001001001000000001
111001100001001001001000000001
100000100001001001001001001001
000000111001001111001001001000
000100000001000001000001001000
000100000001000001000001001000
000000111001111001111111001000
100000100000001000000000001001
111001100000001000000000001001
100001000111001110011001111001
100001000000001000001001000001
100111100000001000001001000001
100100111111111001001001000001
100100100000010001001001001001
100000100000010001001000001001
100000000110010011001000001001
111100000110010010001111001001
100000100110000010000000001001
100000100110000010000000001001
111111111111111111111111111111

111111111111100001111111111111
100000000000100001000000000001
100000000000100001000000000001
111111100100100111001111111001
100000000100100001001000001001
100000000100100001001000001001
100111111100111001001001001001
100000100000100001001001001001
100000100000100001001111001001
100100100100000000000000001001
100100000100000000000000001001
100100000111111111111111111001
111111100100000100000100001001
000000100100000100000100001001
000000000000100000100000001001
000100000000100000100000000001
000111111111111111111111000001
100000000000100000100000000001
100000000000100000100000001001
100000100100000100000100001001
100000100100000100000100001001
111111100111111111111111111001
100000100100000100000100000001
100000100100000100000100000001
100100100000100000100000111001
100100100000100000100000111001
100111100111111111111111111001
100000000000000000000000000001
100000000000000000000000000001
111111111111111111111111111111

111111111111100001111111111111
111110001000100001001110001111
111100010000100001000100000111
101000100011100000100010100011
100001000001000100010001010001
100010001000001110000000001001
110000000100011101000100000001
101000100000111000101000100011
100001010001110000010001110001
100010000011100000001000111001
110001000111000100000100011101
111000100010001000100010001111
111100010100010001110001000111
101000111000100011100000100000
100001110000010001000100010000
100011100010001000001110100000
100001000100000100000111000000
100000001000101000100010000111
100100010001110000010000001001
100110001000100010001000010001
100111000100010101011100000011
111010001000001000100111000101
110000010001000000000011101001
100000100011100010000001110001
100100010001110100001000111001
101000001000111000011100010001
110001000100010000110000000011
100011100000100001100001000111
100111110001100001100011100011
111111111111100001111111111111

111111111111100001111111111111
100010000000100000000000111001
100010000000100000000000111001
100010011100100111111100111001
110010010000100111111100111001
100000010000100110000000111001
100000010000000110000000111001
111100111100000111110011111001
100100111111100111110011111001
100100000000100000000000000001
100100000000100000000000000001
100111111100111111001111001001
100100000000110011001000001001
000100000000110011001000001000
000100111111100001001001001000
000000100100000000001001001000
000000100100001111111001001000
100111100100111110000000000001
100000000100000010000000000001
100000000100000010011110011111
111100111111110010000000000001
100000100000000010000000000001
100000100000000011111111111001
100111111111110010000001000001
100000001000000010000000000001
100000001000000010011000001001
100111001111111110011111111001
100000000000000000010000000001
100000000000000000010000000001
111111111111100001111111111111

111111111111100001111111111111
100000010000000000000000000001
100000010000000000000000000001
111001111111111111111110011111
100000000000000000000000000001
100000000000000000000000000001
111111111100111110011111111111
100000000000100100000000000001
100000000000100100000000000001
111111100111100111111001111111
100000000010000000000000000001
100000000010000000000000000001
111100111111111111111001111111
000000000000000100000000000001
000000000000000100000000000001
000000000000000100000000000001
000000000000000100000000000001
111111111001111111111111110011
100000000000000000000000000001
100000000000000000000000000001
111100111111110011111001111111
100000010000000000100000000001
100000010000000000100000000001
111111111100111111111111111001
100000000000100000000000000001
100000000000100000000000000001
111001111111100111111100111111
100000000000000000000000000001
100000000000000000000000000001
111111111111100001111111111111

111111111111111111111111111111
101000100010001100010001000101
110100000000000000000010101011
100010001000100001000100010001
100010001000100001000100010001
110101010001000010001000001011
101000100010001100010001000101
101000100010001100010001000101
110000000101000010100010001011
100010001000100001000100010001
100010001000100001000100010001
110001010000010000001010001011
101000100010001100010001000111
101000100010001100010001000000
110000010001000010100000101000
100010001000100001000100010000
100010001000100001000100010000
110100010100010000001010001111
101000100010001100010001000101
101000100010001100010001000101
100100000101000010100000100011
100010001000100001000100010001
100010001000100001000100010001
110001000000010000100010100011
101000100010001100010001000101
101000100010001100010001000101
110100000101000000101000001011
100010001000100001000100010001
100010001000100001000100010001
111111111111100001111111111111

111111111111111111111111111111
100100100100100100100100100101
111111011111011111010111011111
100000000100000000100100000101
100100100000100100000100100001
100011111011110011111010111001
100100000100100100100000100101
100000100100100000100100100001
111111001110011110010111001111
100100000100100100100100100101
100100100100100100000100100101
100001111001111011111011110001
100000000100100000100100000001
000100100100100100100100100000
000111001101010110011110011000
000100100100000100100000100000
000100100100100100000100100000
100011101010111011111011111001
100100100100000100000100100101
100100100100100100100000100101
111111010111010110011101011111
100100100000100100100100100001
100100100100100000100100100101
111011111001111011111010101011
100100000100100100100100100101
100100100000100100100000100101
111101011111011111010111010111
100100100000100000000100000101
100100000100000000100000100101
111111111111100001111111111111

111111111111111111111111111111
100000000000000000000001000001
100000000000000000000001000001
100110011111111111111111111001
100100000000000000000000001001
100100000000000000000000001001
100100111111111111111111001001
100100100100000000000000001001
100100100100000000000000001001
100100100111111100111001001001
100100100100010000001001111001
100100100100010000001001001001
100100100100111001001001001001
000100100100100001001001001001
000100100000100001001001001001
000100100000100001111001001001
000100100100100001001001001001
100111100100111001001001001001
100100100100000000001001001001
100100100100000000001111000001
100100100111111111111001000001
100100100000000000000001001001
100100100000000000000001001001
111100111111001111111111001001
100100000000000000000000001001
100100000000000000000000001001
100111111111111111111111111001
100000000000000000000000000001
100000000000000000000000000001
111111111111100001111111111111

end